B                       M                                         B
B                      MMM                                        B
B                                                                 B
B                     BBBB                                        B
B                MMM        BB                                    B
B   MMM         B   B        B                                    B
B           BBBB BBBBB    BBBB                                    B
B        B B                                                      B
B        B                                                        B
BBBBBBBBBBBBBBBBBBBBBBBBBBBBBBBBBBBBBBBBBBBBBBBBBBBBBBBBBBBBBBBBBBB