                                                                  B
    M                                                             B
B  MMM           B                                                B
B  MMMM          B                                                B
B MMMMMM    MMMM B                                                B
B          MMMMMMB         MMMMMMMMMMMMMMMMMMMMMMMMMMMMMMMMMM     B
BBB     MMMMMBBBBB                                                B
B    MMMMMMMMMM BB                                                B
B                                       MMMMMMMMMMMMM             B
BBBBBBBBBBBBBBBBBBBBBBBBBBBBBBBBBBBBBBBBBBBBBBBBBBBBBBBBBBBBBBBBBBB